Hd, Hd, Hd, Mdd, Mdd, Mdd, Mdd, Hd, Hd, Hd, Mdd, Mdd, Mdd, Mdd, Mdd, Hd, Gd^Fts, Gd^Fts, Gd^Fts, Gd^Fts, Gd^Fts, Gd^Fts, Rp, Dd, Dd, Dd, Gs^Ft, Gs
Hd, Hd, Mdd, Mdd, Mdd, Mdd, Mdd, Mdd, Hd, Hd, Mdd, Mdd, Mdd, Mdd, Mdd, Hd, Hd, Gd^Fts, Gd^Fts, Gd^Fts, Gd^Fts, Rp, Dd, Dd, Dd, Dd, Gs^Ft, Gs
Hd, Mdd, Mdd, Mdd, Mdd, Mdd, Mdd, Hd, Hd, Hd, Hd, Mdd, Mdd, Mdd, Mdd, Hd, Hd, Dd^Vda, Gd^Fts, Gd^Fts, Gd^Fts, Rp, Rd, Gs^Ft, Dd, Gs^Ft, Gs^Vht, Gs^Ft
Hd, Hd, Mdd, Mdd, Mdd, Mdd, Mdd, Hd, Rd, Rd, Rd, Hd, Gd^Fts, Gd^Fts, Gd^Fts, Mdd, Gd^Fts, Gd^Fts, Re, Gd^Fts, Ch, Ch, Ch, Rd, Rd, Gs^Ft, Gs^Ft, Dd
Hd, Hd, Hd, Hd, Hd, Mdd, Ch, Ch, Ch, Gs^Ft, Re, Re, Hd, Mdd, Mdd, Gd^Fts, Hd, Hd, Re, Re, Ch, Kh, Ch, Rd, Rd, Rd, Dd, Dd
Hd, Hd, Hd, Hd, Hd, Hd, Ch, 2 Kh, Ch, Rd, Rd, Rd, Rd, Hd, Mdd, Mdd, Hd, Hd, Rd, Hd, Ch, Ch, Hd, Hd, Hd, Hd, Hd, Hd
Rd, Hd, Hd, Hd, Hd, Dd, Ch, Ch, Dd, Dd, Gs^Ft, Rd, Rd, Hd, Hd, Hd, Rd, Rd, Rd, Rd, Rd, Hd, Mdd, Mdd, Mdd, Mdd, Mdd, Hd
Rd, Rd, Rd, Rd, Dd^Ftd, Dd, Dd, Dd, Dd, Dd, Ww, Dd, Rd, Dd, Rd, Rd, Hd, Rd, Dd^Vdt, Rd, Hd, Hd, Mdd, Mdd, Mdd, Mdd, Mdd, Mdd
Re, Re, Re, Dd^Ftd, Dd^Ftd, Dd^Ftd, Dd, Ww, Dd, Ww, Ww, Ww, Dd, Rd, Dd, Hd, Hd, Rd, Hd, Rd, Rd, Mdd, Mdd, Mdd, Mdd, Mdd, Mdd, Mdd
Gs, Dd^Ftd, Rd, Rd, Dd^Vda, Ww, Ww, Ww, Dd, Dd, Ww, Dd^Vda, Rd, Re, Rd, Hd, Rd, Rd, Hd, Hd, Rd, Mdd, Mdd, Mdd, Mdd, Mdd, Mdd, Mdd
Rd, Dd, Rd, Rd, Rd, Ww, Ww, Dd, Dd, Dd, Dd, Dd, Rd, Re, Re, Re, Dd, Gs^Ft, Gs^Ft, Gs^Ft, Rd, Hd, Mdd, Mdd, Mdd, Mdd, Mdd, Mdd
Dd, Rd, Dd^Vda, Re, Re, Dd, Dd, Dd, Rd, Rd, Rd, Rd, Re, Re, Rd, Rd, Dd, Dd, Dd, Gs^Ft, Rd, Hd, Mdd, Mdd, Mdd, Mdd, Mdd, Mdd
Rd, Re, Rd, Rd, Dd^Vda, Rd, Rd, Rd, Dd, Dd, Dd, Dd, Re, Re, Rd, Rd, Dd, Dd, Gs^Ft, Gs^Ft, Rd, Gs^Ft, Gs^Ft, Hd, Mdd, Mdd, Mdd, Mdd
Rd, Re, Re, Rd, Re, Rd, Rd, Rd, Rd, Dd^Ftd, Gs^Vht, Dd^Ftd, Rd, Dd, Dd, Dd, Dd, Gs^Ft, Re, Re, Re, Re, Re, Rd, Hd, Hd, Hd, Hd
Rd, Rd, Rd, Re, Gs^Ft, Dd, Hd, Hd, Gs^Ft, Re, Re, Re, Re, Gs^Ft, Gs^Ft, Rd, Gs^Ft, Re, Gs, Ww, Ww, Dd, Re, Rd, Rd, Gs^Ft, Dd, Dd
Dd^Ftd, Dd^Ftd, Dd^Ftd, Ch, Ch, Ch, Rd, Hd, Re, Re, Rd, Rd, Rd, Re, Re, Rd, Re, Re, Ww, Wo, Ww, Dd^Vda, Re, Rd, Rd, Gs^Ft, Dd, Dd
Dd, Dd, Dd, Ch, Kh, Ch, Hd, Re, Rd, Rd, Rd, Rd, Rd, Rd, Rd, Re, Rd, Dd^Vda, Ww, Wo, Ww, Ww, Re, Rd, Rd, Dd, Dd, Dd
Dd, Dd, Dd, Ch, Ch, Gs^Ft, Rd, Rd, Rd, Rd, Dd, Rd, Rd, Rd, Rd, Rd, Rd, Rd, Ww, Ww, Dd, Ch, Ch, Ch, Rd, Dd, Dd, Dd
Gs^Ft, Hd, Hd, Hd, Hd, Rd, Rd, Rd, Rd, Rd, Ww, Ww, Dd^Vda, Rd, Rd, Rd, Rd, Dd, Rd, Rd, Rd, Ch, 1 Kh, Ch, Rd, Gs^Ft, Dd, Dd
Gs, Dd, Dd^Ftd, Dd, Dd^Ftd, Dd^Ftd, Dd^Ftd, Rd, Dd^Ftd, Ww, Wo, Ww, Ww, Dd, Rd, Rd, Rd, Rd, Rd, Rd, Rd, Ch, Ch, Re, Re, Rd, Gs^Ft, Dd
Dd^Ftd, Dd^Ftd, Dd^Ftd, Dd^Ftd, Dd^Ftd, Dd, Dd, Dd^Ftd, Dd, Ww, Ww, Ww, Ww, Rd, Rd, Dd^Vda, Rd, Rd, Hd, Hd, Mdd, Mdd, Hd, Hd, Re, Gs^Ft, Gs^Ft, Gs^Ft
Rd, Dd^Ftd, Dd^Ftd, Gs^Vht, Dd^Ftd, Dd, Dd, Dd, Ww, Ww, Ww, Ww, Dd, Dd, Dd^Ftd, Rd, Hd, Hd, Mdd, Mdd, Mdd, Mdd, Mdd, Hd, Rd, Dd, Gs, Dd
Rd, Rd, Rd, Dd^Ftd, Dd^Ftd, Dd, Dd^Ftd, Dd, Ww, Ww, Ww, Dd, Dd, Dd, Dd, Hd, Hd, Mdd, Mdd, Mdd, Mdd, Mdd, Mdd, Hd, Rd, Dd, Gs^Ft, Dd
Rd, Rd, Rd, Dd, Dd, Dd^Ftd, Dd, Ww, Ww, Ww, Gs, Gs, Dd, Dd, Hd, Mdd, Mdd, Mdd, Mdd, Mdd, Mdd, Hd, Hd, Re, Dd^Vda, Dd, Dd, Dd
Rd, Rd, Rd, Dd, Dd^Ftd, Dd^Ftd, Dd^Ftd, Ww, Ww, Ww, Dd, Dd, Dd, Hd, Hd, Mdd, Mdd, Mdd, Mdd, Mdd, Mdd, Hd, Hd, Re, Re, Dd, Dd, Dd
Rd, Rd, Dd^Ftd, Dd^Ftd, Dd^Ftd, Rd, Dd, Ww, Ww, Ww, Dd, Dd, Hd, Hd, Hd, Mdd, Mdd, Mdd, Mdd, Hd, Hd, Hd, Rd, Rd, Rd, Rd, Rd, Dd
Hd, Hd, Rd, Dd^Ftd, Dd^Ftd, Dd^Ftd, Dd, Ww, Ww, Dd^Vda, Dd, Dd, Hd, Hd, Hd, Hd, Hd, Hd, Hd, Rd, Rd, Rd, Rd, Rd, Rd, Dd, Rd, Dd
Hd, Hd, Hd, Dd, Dd, Dd^Ftd, Gs, Ww, Dd, Gs, Gs^Ft, Dd, Hd, Hd, Mdd, Hd, Hd, Dd, Dd, Rd, Rd, Rd, Rd, Rd, Dd, Dd, Rd, Dd
