Dd, Rp, Rp, Gs, Dd, Dd, Dd, Dd, Dd, Dd, Dd, Dd, Dd, Ww, Wo, Wo, Wo, Wo, Wo, Wo, Wo, Wo
Hd, Dd, Dd, Rp, Dd, Dd, Dd, Dd, Dd, Dd, Dd, Dd, Dd, Dd, Ww, Wo, Wo, Wo, Wo, Wo, Wo, Wo
Hd, Hd, Dd, Rp, Dd, Dd, Dd, Hd, Hd, Hd, Hd, Hd, Dd, Dd, Dd, Ww, Wo, Wo, Wo, Wo, Wo, Wo
Hd, Dd, Dd, Ch, Ch, Ch, Dd, Hd, Hd, Hd, Hd, Hd, Dd, Dd, Dd, Ww^Vm, Ww, Wo, Wo, Wo, Wo, Wo
Dd, Dd, Gs^Ft, Ch, 1 Kh, Ch, Gs^Ft, Gs^Ft, Hd, Hd, Hd, Hd, Dd, Gs^Ft, Gs, Ww, Ww, Wo, Wo, Wo, Wo, Wo
Gs, Gs, Ch, Ch, Ch, Gs, Gs, Gs, Gs, Dd, Dd, Dd, Gs^Ft, Gs, Gs, Ww, Ww, Wo, Wo, Wo, Wo, Wo
Gs, Gs, Gs, Gs, Rd, Dd, Gs^Ft, Gs, Gs, Gs^Ft, Dd, Dd, Gs^Ft, Gs, Gs, Ww, Ww, Wo, Wo, Wo, Wo, Wo
Gs, Gs, Gs, Gs^Ft, Gs^Ft, Rd, Dd^Vda, Gs^Ft, Gs^Vht, Gs^Ft, Gs, Gs, Gs, Gs, Gs, Dd, Ww, Wo, Wo, Wo, Wo, Wo
Gs, Gs, Gs^Ft, Dd, Re, Rd, Dd, Dd, Gs^Ft, Dd, Gs, Gs, Gs, Gs, Gs, Dd^Vda, Ww, Wo, Wo, Wo, Wo, Wo
Gs, Gs^Ft, Gs, Gs, Re, Gs^Ft, Dd, Dd, Dd, Dd, Gs, Hd, Hd, Gs, Gs, Ww, Ww, Wo, Wo, Wo, Wo, Wo
Gs, Gs, Gs, Gs, Re, Gs^Ft, Dd, Dd, Gs^Ft, Gs^Ft, Gs, Hd, Hd, Gs, Gs, Ww, Ww, Wo, Wo, Wo, Wo, Wo
Gs, Gs, Gs, Gs, Gs, Re, Re, Dd, Gs^Ft, Gs^Ft, Gs^Ft, Hd, Gs, Gs, Gs, Ww, Ww, Wo, Wo, Wo, Wo, Wo
Hd, Ww, Ww, Gg^Vh, Ww, Ww, Ch, Ww, Ww, Gs^Ft, Gs^Ft, Dd, Dd, Dd, Dd, Ww, Ww, Wo, Wo, Wo, Wo, Wo
Ww, Ww, Ww, Ww, Ww, Hd, Hd, Re, Rd, Ww, Dd, Dd, Dd, Dd, Ww, Ww, Wo, Wo, Wo, Wo, Wo, Wo
Ww, Ww, Ww, Ww, Ww, Ww, Mdd, Hd, Rd, Ww, Ww, Dd^Vda, Ww, Ww, Ww, Wo, Wo, Wo, Wo, Wo, Wo, Wo
Ww, Ww, Ww, Ww, Ww, Ww, Mdd, Hd, Dd, Rd, Dd, Ww, Ww, Ww, Ww, Wo, Wo, Wo, Wo, Wo, Wo, Wo
Ww, Ww, Ww, Ww, Ww, Ww, Mdd, Mdd, Hd, Rd, Dd, Dd, Dd, Ww, Ww, Wo, Wo, Wo, Wo, Wo, Wo, Wo
Mdd, Ww, Ww, Ww^Vm, Ww, Mdd, Mdd, Mdd, Mdd, Re, Re, Dd, Dd, Ww, Ww, Wo, Wo, Wo, Wo, Wo, Wo, Wo
Ww, Mdd, Ww, Ww, Ww, Ww, Ww, Ww, Mdd, Hd, Re, Dd, Gs, Dd, Ww, Wo, Wo, Wo, Wo, Wo, Wo, Wo
Ww, Ww, Ww, Ww, Ww, Ww, Ww, Mdd, Mdd, Hd, Dd, Rd, Gs, Ww, Ww, Wo, Wo, Wo, Wo, Wo, Wo, Wo
Ww, Ww, Ww, Ww, Ww, Ww, Ww, Ww, Hd, Ch, Ch, Ch, Dd, Ww, Wo, Wo, Wo, Wo, Wo, Wo, Wo, Wo
Ww, Ww, Ww, Ww, Ww, Ww, Ww, Ww, Hd, Ch, 2 Kh, Ch, Gs, Ww, Wo, Wo, Wo, Wo, Wo, Wo, Wo, Wo
Ww, Ww, Ww, Ww, Ww, Ww, Ww, Ww, Ch, Ch, Ch, Gs, Gs, Ww, Wo, Wo, Wo, Wo, Wo, Wo, Wo, Wo
Ww, Ww, Ww, Ww, Ww, Ww, Ww, Hd, Dd, Rp, Gs, Gs, Dd, Ww, Wo, Wo, Wo, Wo, Wo, Wo, Wo, Wo
Ww, Ww, Ww, Ww, Ww, Ww, Ww, Gs, Rp, Rp, Gs, Gg^Vh, Ww, Ww, Wo, Wo, Wo, Wo, Wo, Wo, Wo, Wo
Ww, Ww, Ww, Ww, Hd, Gg^Vh, Rp, Rp, Ww, Ww, Ww, Ww, Ww, Ww, Wo, Wo, Wo, Wo, Wo, Wo, Wo, Wo
Ww, Hd, Hd, Hd, Hd, Gs^Ft, Rp, Ww, Wo, Wo, Wo, Wo, Wo, Wo, Wo, Wo, Wo, Wo, Wo, Wo, Wo, Wo
