Gs, Gs, Dd, Dd, Dd, Dd, Dd, Dd, Rd, Rd, Re, Rd, Rd, Rd, Rd, Dd^Ftd, Dd, Rd, Dd, Dd, Ww, Ww, Ww, Dd, Dd, Dd, Ww, Ww
Gs, Gs, Dd, Dd, Dd, Dd, Rd, Rd, Dd^Ftd, Dd^Ftd, Gs^Vht, Dd^Ftd, Rd, Dd^Ftd, Gs^Vht, Dd^Ftd, Rd, Rd, Dd, Dd, Dd, Ww, Ww, Ww, Ww, Ww, Ww, Dd
Gs, Gs, Dd, Dd, Rd, Rd, Dd, Dd, Gs^Vht, Dd^Ftd, Dd, Dd^Ftd, Rd, Rd, Dd^Ftd, Rd, Dd, Dd, Dd^Ftd, Dd^Ftd, Dd, Dd, Ww, Ww, Ww, Dd, Dd, Dd
Dd, Dd^Ftd, Rd, Ch, Ch, Ch, Dd, Dd^Ftd, Dd^Ftd, Dd^Ftd, Dd^Ftd, Dd^Ftd, Rd, Rd, Rd, Rd, Dd^Ftd, Rd, Rd, Dd^Ftd, Dd, Ww, Ww, Ww, Ww, Dd, Dd, Dd^Ftd
Rd, Rd, Dd^Ftd, Ch, 1 Kh, Ch, Dd, Dd, Dd^Ftd, Rd, Rd, Rd, Rd, Rd, Rd, Re, Rd, Rd, Rd, Dd^Ftd, Dd, Ww, Ww, Ww, Ww, Dd, Dd, Dd^Ftd
Dd, Dd^Ftd, Ch, Ch, Ch, Dd, Dd, Dd, Dd, Rd, Dd^Ftd, Rd, Rd, Rd, Rd, Re, Rd, Dd^Ftd, Rd, Dd, Dd, Dd, Ww, Ww, Ww, Dd, Dd, Dd^Ftd
Dd, Dd^Ftd, Re, Dd, Dd, Dd, Dd, Dd, Dd, Dd, Dd^Ftd, Rd, Rd, Rd, Rd, Re, Rd, Rd, Dd, Gll^Feth, Dd, Dd, Ww, Ww, Ww, Dd, Dd, Dd^Ftd
Dd, Dd^Ftd, Re, Dd^Ftd, Dd, Dd, Dd, Dd, Dd, Dd, Dd, Dd, Rd, Rd, Rd, Re, Rd, Rd, Dd, Dd, Dd, Dd, Dd, Dd^Vda, Dd, Dd, Dd, Dd^Ftd
Dd, Gs, Re, Dd, Dd^Vda, Dd, Dd, Dd, Dd, Dd, Dd, Dd, Dd^Ftd, Rd, Re, Re, Rd, Rd, Dd, Dd, Dd, Dd, Dd, Dd, Dd, Dd, Dd, Rd
Dd^Ftd, Gs, Re, Dd, Dd, Dd, Dd, Gll^Feth, Dd, Ww, Ww, Dd, Dd, Re, Rd, Gg^Vh, Gs^Ft, Rd, Rd, Dd^Ftd, Dd, Dd^Ftd, Dd, Dd, Dd, Dd^Ftd, Rd, Rd
Dd, Dd, Re, Dd, Dd, Dd, Dd, Dd, Dd, Dd, Dd, Dd, Dd, Rd, Rd, Rd, Rd, Rd, Rd, Rd, Rd, Rd, Dd^Ftd, Dd, Dd^Ftd, Rd, Rd, Rd
Dd, Dd, Dd^Ftd, Rd, Rd, Dd, Dd, Ww, Dd, Dd, Dd^Vda, Dd, Rd, Rd, Dd^Ftd, Rd, Rd, Rd, Rd, Rd, Rd, Rd, Rd, Rd, Rd, Rd, Gg^Vh, Rd
Rd, Dd, Dd^Ftd, Dd, Rd, Dd^Ftd, Ww, Ww, Ww, Dd, Dd, Rd, Dd, Dd, Dd, Rd, Rd, Rd, Rd, Rd, Rd, Rd, Rd, Rd, Rd, Rd, Rd, Rd
Rd, Re, Re, Dd^Ftd, Rd, Dd, Ww, Ww, Dd^Ftd, Dd, Rd, Rd, Dd, Dd, Dd, Dd^Ftd, Rd, Rd, Rd, Rd, Rd, Rd, Rd, Rd, Rd, Rd, Rd, Rd
Rd, Rd, Rd, Re, Rd, Dd, Dd^Vda, Dd, Dd^Ftd, Dd, Rd, Dd, Dd, Dd, Dd, Dd, Dd, Dd^Ftd, Dd^Ftd, Dd, Dd, Dd, Dd, Dd^Ftd, Dd^Ftd, Rd, Rd, Rd
Rd, Rd, Rd, Re, Re, Dd, Ww, Dd, Dd, Rd, Dd, Rd, Dd, Dd, Dd, Dd, Dd, Dd, Dd, Dd, Dd, Dd, Dd^Vda, Dd, Dd, Dd, Dd, Gs^Ft
Rd, Rd, Rd, Rd, Re, Rd, Ww, Dd^Ftd, Rd, Rd, Rd, Rd, Rd, Dd, Dd, Dd, Dd, Dd, Dd, Gll^Feth, Dd, Dd, Dd, Dd, Dd, Dd, Dd, Gs^Ft
Rd, Rd, Rd, Rd, Re, Rd, Rd, Rd, Dd, Dd, Rd, Rd, Rd, Dd, Hd, Dd, Dd^Vda, Dd, Dd, Rd, Rd, Dd, Dd, Dd, Dd, Dd, Dd, Gs^Ft
Dd^Ftd, Rd, Rd, Rd, Rd, Re, Re, Re, Rd, Dd, Rd, Rd, Rd, Dd, Dd, Dd, Gll^Feth, Dd, Dd, Dd, Dd, Hd, Dd, Dd, Dd, Dd, Gs^Ft, Gs
Dd, Dd, Dd, Dd^Ftd, Rd, Rd, Rd, Re, Rd, Rd, Rd, Gg^Vh, Rd, Dd, Dd, Dd, Dd, Dd, Dd, Dd^Ftd, Hd, Hd, Hd, Gg^Vh, Hd, Gs, Gs, Gs
Dd, Dd^Vda, Dd, Dd, Dd, Dd, Dd^Ftd, Rd, Dd^Ftd, Rd, Rd, Rd, Dd, Rd, Rd, Dd, Dd, Dd, Dd, Hd, Hd, Hd, Hd, Hd, Hd, Hd, Hd, Gs
Dd, Dd, Dd, Dd^Vda, Dd, Dd, Dd, Rd, Dd, Dd^Ftd, Rd, Rd, Rd, Dd, Dd, Rd, Rd, Dd, Hd, Hd, Hd, Hd, Hd, Hd, Hd, Hd, Hd, Gs
Dd, Dd, Dd, Dd, Dd, Dd, Dd, Rd, Dd, Dd, Dd^Ftd, Dd^Ftd, Dd^Ftd, Re, Dd, Dd, Rd, Dd, Hd, Hd, Hd, Hd, Hd, Hd, Hd, Hd, Hd, Dd
Dd, Dd, Dd, Dd, Dd, Dd, Rd, Rd, Dd, Dd, Dd^Ftd, Dd^Ftd, Rd, Re, Rd, Dd, Rd, Dd, Dd, Hd, Hd, Hd, Hd, Hd, Hd, Dd, Dd, Dd
Dd, Dd, Dd, Ch, Ch, Ch, Rd, Dd, Dd, Dd, Dd, Rd, Rd, Rd, Re, Dd^Ftd, Rd, Dd, Rd, Dd, Hd, Ch, Ch, Ch, Dd, Dd, Dd, Gs
Dd, Dd, Dd, Ch, 3 Kh, Ch, Rd, Dd, Dd, Gll^Feth, Dd, Rd, Dd, Dd, Rd, Dd, Dd^Vda, Rd, Dd, Rd, Rd, Ch, 2 Kh, Ch, Dd, Gs, Gs, Gs
Dd, Dd, Ch, Ch, Ch, Dd, Rd, Dd, Dd, Dd, Dd^Vda, Dd, Ww, Ww, Dd, Rd, Dd, Dd, Dd, Dd, Ch, Ch, Ch, Dd, Dd, Gs, Gs, Gs
Dd, Dd, Dd, Gs^Ft, Rd, Rd, Re, Dd^Ftd, Dd, Dd, Dd, Ww, Ww, Ww, Dd, Re, Rd, Dd^Ftd, Dd, Dd, Dd, Dd, Gs^Ft, Dd, Dd, Gs, Gs, Gs
Dd, Dd, Dd^Vda, Dd, Rd, Rd, Re, Rd, Dd, Dd, Dd, Ww, Ww, Ww, Gs^Ft, Rd, Rd, Rd, Rd, Dd, Dd, Dd, Gs^Ft, Dd, Dd^Vda, Dd, Dd, Dd
Dd, Dd, Dd, Gs^Ft, Rd, Rd, Rd, Re, Rd, Dd, Dd, Ww, Ww, Ww, Dd, Rd, Dd^Ftd, Dd, Rd, Dd, Dd, Dd, Dd, Ww, Ww, Ww, Ww, Dd
Dd, Dd, Hd, Rd, Rd, Rd, Dd^Ftd, Dd^Ftd, Dd, Rd, Rd, Ww, Ww, Ww, Dd, Rd, Dd^Ftd, Dd, Rd, Dd, Dd, Dd, Ww, Ww, Ww, Ww, Ww, Ww
