Dd, Dd, Dd, Dd, Dd, Dd, Dd, Dd, Dd, Dd, Dd, Dd, Dd, Dd, Gd^Fts, Gd^Fts, Gd^Fts, Gg, Gg, Gg, Gg, Gg, Hh, Hh, Hh, Hh, Rd, Ww, Ww, Ww, Ww, Ww, Ww, Ww, Mm, Ww, Ww, Ww, Mm, Ww
Dd, Dd, Dd, Dd, Dd, Dd, Dd, Dd, Dd, Dd, Dd, Dd, Dd, Dd, Gd^Fts, Gd^Fts, Gd^Fts, Gg, Gg, Gg, Gg, Gg, Gg, Hh, Hh, Hh, Rd, Ww, Ww, Ww, Ww, Mm^Vhh, Mm, Mm, Mm, Ww, Mm, Ww, Ww, Ww
Dd, Dd, Gd^Fts, Dd, Dd, Dd, Gg^Vh, Dd, Rr, Rr, Rr, Dd, Dd, Dd, Dd, Gd^Fts, Gd^Fts, Gg, Gg, Gg, Gg, Gg, Gg, Hh, Hh, Hh, Hh, Mm, Ww, Ww, Mm, Mm, Mm, Mm, Mm, Ww, Mm, Mm, Mm^Vhh, Ww
Dd, Dd, Dd, Gd^Fts, Dd, Dd, Rr, Rr, Dd, Dd, Dd, Rr, Rr, Gg^Vh, Rr, Gd^Fts, Gd^Fts, Gg, Gg, Gg, Gg, Gg, Gg, Gg, Hh, Hh, Hh, Hh, Mm, Mm, Mm, Mm, Mm, Mm, Ww, Ww, Mm, Mm, Mm, Mm
Dd, Dd, Dd, Ch, Ch, Ch, Dd, Dd, Dd, Dd, Dd, Dd, Dd, Rr, Dd, Rr, Rr, Rr, Rr, Gg, Gg, Gg, Gg, Gg, Hh, Hh, Hh, Hh, Mm, Mm, Mm, Mm, Mm, Ww, Ww, Mm, Mm, Mm, Mm, Mm
Dd, Dd, Dd, Ch, 1 Kh, Ch, Dd, Dd, Dd, Dd, Dd, Dd, Dd, Dd, Dd, Dd, Gs^Fms, Gg, Rr, Gg, Gg, Gg, Rr, Gg, Gg, Hh, Hh, Hh, Hh, Mm, Mm, Mm, Mm, Ww, Ww, Mm, Mm, Mm, Mm, Mm
Rd, Dd, Ch, Ch, Ch, Dd, Dd, Dd, Dd, Gd^Fts, Dd, Dd, Dd, Dd, Dd, Dd, Dd, Gs^Fms, Dd, Rr, Rr, Rr, Gg^Vh, Rr, Rr, Hh, Hh, Ch, Ch, Ch, Mm, Ww, Ww, Ww, Ww, Mm, Mm, Mm, Mm, Mm
Rd, Rd, Dd, Dd, Dd, Dd, Dd, Dd, Dd, Gd^Fts, Dd, Dd, Dd, Dd, Dd, Dd, Gs^Fms, Dd, Ww, Dd, Gs^Fms, Gs^Fms, Gg, Gg, Rr, Gg, Hh, Ch, 2 Kh, Ch, Mm^Vhh, Ww, Ww, Ww, Ww, Ww, Mm, Mm, Mm, Mm
Dd, Dd, Dd, Dd, Dd, Dd, Dd, Ww, Ww, Dd, Gg^Vh, Dd, Ww, Ww, Ww, Dd, Ww, Ww, Gg, Ww, Gg, Gg, Ww, Gg, Gg, Rr, Ch, Ch, Ch, Hh, Ww, Ww, Ww, Ww, Ww, Ww, Mm, Mm, Mm, Mm
Dd, Dd, Dd, Dd, Dd, Dd, Ww, Ww, Gg^Vh, Ww, Ww, Ww, Gd^Fts, Hh, Ww, Ww, Ww, Gg^Vh, Gg, Ww, Ww, Ww, Ww, Gg, Ww, Gg, Gs^Fms, Hh, Hh, Hh, Hh, Ww, Ww, Ww, Ww, Mm^Vhh, Ww, Ww, Ww, Mm
Dd, Dd, Dd, Dd, Dd, Dd, Dd, Ww, Ww, Gg, Ww, Ww, Ww, Ww, Ww, Ww, Gg, Ww, Ww, Ww, Ww, Ww, Ww, Ww, Ww, Ww, Ww, Hh, Hh, Hh, Hh, Mm, Ww, Ww, Ww, Ww, Ww, Mm, Ww, Mm
Rd, Dd, Dd, Dd, Dd, Dd, Dd, Rd, Ww, Ww, Ww, Ww, Gd^Fts, Ww, Gd^Fts, Gg, Gg, Ww, Gg, Ww, Gg, Gg, Gg, Ww, Gg^Vh, Ww, Ww, Gs^Fms, Ww, Hh, Hh, Mm, Mm, Mm, Mm, Mm, Mm, Mm, Ww, Mm
Rd, Dd, Dd, Dd, Dd, Dd, Rd, Rd, Ww, Ww, Ww, Gd^Fts, Gd^Fts, Gd^Fts, Gd^Fts, Gg, Gg, Gg^Vh, Ww, Ww, Rr, Rr, Rr, Rr, Rr, Gg, Gs^Fms, Ww, Ch, Hh, Mm, Mm, Mm, Mm, Mm, Mm, Rr, Rr, Ww^Bw\, Ww
Rd, Dd, Dd, Dd, Dd, Dd, Rd, Rd, Ww, Ww, Ww, Gd^Fts, Gd^Fts, Gd^Fts, Gd^Fts, Gg, Rr, Rr, Ch, Rr, Rd, Rd, Gg, Gg, Gg, Rr, Rr, Ww^Bw/, Ww, Rr, Rr, Mm, Rr, Rr, Rr, Rr, Mm, Mm, Mm, Rr
Dd, Dd, Dd, Dd, Rd, Rd, Rd, Rd, Dd, Ww, Gg^Vh, Gd^Fts, Gd^Fts, Gd^Fts, Dd, Rr, Gg, Ww, Ww, Gg, Rd, Rd, Gg, Gg, Gg, Gg, Gg, Ww, Hh, Hh, Mm, Rr, Mm, Mm^Vhh, Mm, Mm, Mm, Mm, Mm, Ww
Dd, Dd, Dd, Dd, Rd, Dd, Dd, Dd, Dd, Dd, Dd, Dd, Dd, Dd, Rr, Rr, Gg, Gg, Rd, Rd, Rd, Rd, Gg, Gg, Gg, Gg, Hh, Ww, Hh^Vhh, Hh, Mm, Mm, Mm, Mm, Mm, Mm, Mm, Mm, Mm, Mm
Dd, Dd, Dd, Dd, Dd, Dd, Dd, Dd, Dd, Dd, Dd, Dd, Rr, Rr, Ww, Ww, Gg, Gg, Rd, Rd, Rd, Rd, Gg, Gg, Gg, Gg, Hh, Ww, Ww, Mm, Mm, Mm, Mm, Mm, Mm, Mm, Mm, Mm, Mm, Mm
Dd, Dd, Dd, Dd, Dd, Gg^Vh, Dd, Gd^Fts, Dd, Dd, Dd, Rr, Gg, Ww, Ww, Ww, Gg, Ww, Ww, Ww, Ww, Ww, Ww, Gg, Gg, Gg, Hh, Hh, Ww, Ww, Ww, Mm, Mm, Mm, Mm, Mm, Mm, Mm, Mm, Mm
Dd, Dd, Dd, Dd, Dd, Gd^Fts, Gd^Fts, Gd^Fts, Gd^Fts, Dd, Rr, Rd, Gg, Ww, Ww, Rd, Rd, Ww, Gg, Ww, Gg^Vh, Ww, Ww, Gg, Gg, Gg, Hh, Hh, Hh, Ww, Ww, Mm, Mm, Mm, Mm, Mm, Mm, Mm, Mm, Mm
Dd, Dd, Gd^Fts, Gd^Fts, Dd, Gd^Fts, Gd^Fts, Gd^Fts, Gd^Fts, Dd, Rr, Ww, Ww, Ww, Gg, Rd, Rd, Ww, Gg^Vh, Gg, Gg, Ww, Gg, Gg, Gg, Gg, Hh, Hh, Hh, Hh, Mm, Ww, Mm, Mm, Mm, Mm, Mm, Mm, Mm, Mm
Dd, Dd, Gd^Fts, Gd^Fts, Gd^Fts, Gd^Fts, Gd^Fts, Gd^Fts, Rr, Rr, Gg, Ww, Ww, Gg, Gg, Gg, Rd, Ww, Gg, Gg, Gg, Gs^Fms, Gg, Gg, Gg, Hh, Hh, Hh, Hh, Hh, Mm, Ww, Ww, Mm, Mm, Mm, Mm, Mm, Mm, Mm
Dd, Dd, Dd, Gd^Fts, Gd^Fts, Gg, Gg, Gd^Fts, Rr, Gd^Fts, Gg, Ww, Ww, Gg, Gg, Gg, Rd, Gg, Gg, Gs^Fms, Gs^Fms, Gs^Fms, Gs^Fms, Gg, Gg, Hh, Hh, Hh, Hh, Hh, Ww, Ww, Ww, Ww, Mm, Mm, Mm, Mm, Mm, Mm
