Ha, Hh, Mm, Mm, Mm, Ha, Hh, Hh, Rr, Hh, Hh, Hh, Hh, Hh, Hh, Hh, Hh, Hh, Hh, Hh, Hh, Mm, Mm, Mm, Mm, Mm, Mm, Mm, Mm, Mm
Ha, Hh, Hh, Hh, Hh, Hh, Hh, Hh, Hh, Rr, Hh, Hh, Hh, Hh, Hh, Hh, Hh, Hh, Hh, Hh, Hh, Hh, Mm, Mm, Mm, Mm, Mm, Mm, Mm, Mm
Ha, Hh, Hh, Hh, Hh, Hh, Hh, Ha, Hh, Rr, Hh, Hh, Gs^Fp, Gs^Fp, Gs^Fp, Gs^Fp, Gs^Fp, Gs^Fp, Gs^Fp, Hh, Hh, Hh, Hh, Hh, Mm, Mm, Mm, Mm, Mm, Mm
Gg, Gg, Gg, Hh, Hh, Hh, Hh, Ha, Aa, Aa, Aa, Gg^Vh, Rr, Gg^Ve, Rr, Ch, Ch, Ch, Gs^Fp, Gs^Fp, Hh, Hh, Hh, Hh, Mm, Mm, Mm, Mm, Mm, Mm
Gg, Gg, Gg, Gs^Fp, Gg^Ve, Gs^Fp, Gg, Gg, Gg, Aa, Gg, Rr, Gg, Rr, Gs^Fp, Ch, 1 Kh, Ch, Rr, Rr, Rr, Gg, Hh, Hh, Hh, Hh, Mm, Mm, Mm, Mm
Aa, Gg, Gg, Gs^Fp, Gs^Fp, Gs^Fp, Gs^Fp, Gg, Gg, Aa, Aa, Gg, Gg, Gg, Ch, Ch, Ch, Gs^Fp, Gs^Fp, Gs^Fp, Gg^Vh, Rr, Rr, Hh, Hh, Hh, Hh, Hh, Hh, Mm
Aa, Gg, Gg, Gs^Fp, Gs^Fp, Gs^Fp, Gs^Fp, Gs^Fp, Gg, Gg, Gg, Gg, Gg, Gg, Gg, Gg, Rr, Gs^Fp, Gs^Fp, Gg, Gs^Fp, Gg, Gg, Rr, Rr, Gg, Gg, Hh, Hh, Hh
Aa, Gg, Gg, Gs^Fp, Gg^Ve, Gs^Fp, Gs^Fp, Gs^Fp, Gg, Gg, Gg, Gg, Gg, Gg, Gg, Gg, Rr, Gg, Gg, Gs^Fp, Gg, Gg, Gs^Fp, Gg, Gg^Vh, Rr, Rr, Gs^Fp, Hh, Hh
Aa, Aa, Gg, Gg, Gs^Fp, Gs^Fp, Gg, Gg, Gg, Gg, Gg, Gg, Gg, Gg, Gg, Rr, Gs^Fp, Gs^Fp, Gs^Fp, Gg, Gg, Gg, Gg, Gg, Gg, Gg, Gg, Rr, Rr, Rr
Ai, Aa, Gg, Gg, Gs^Fp, Gs^Fp, Gs^Fp, Gs^Fp, Gs^Fp, Gs^Fp, Gs^Fp, Gg, Gg, Gg, Rr, Rr, Gs^Fp, Gs^Fp, Gs^Fp, Gg, Gg, Gg, Gg, Gg, Gg, Gg, Gg, Gg, Rr, Gg
Ww, Gg, Gg, Gs^Fp, Gs^Fp, Gs^Fp, Gs^Fp, Gg, Ww, Ww, Ww, Gs^Fp, Gg, Gg, Rr, Gs^Fp, Gs^Fp, Gs^Fp, Gs^Fp, Gg, Gg, Gg, Gg, Gg, Rr, Rr, Rr, Rr, Gg, Rr
Ww, Gg, Gg, Gs^Fp, Gs^Fp, Gg, Gg, Ww, Ww, Ww, Gs^Fp, Gg^Vh, Gg, Gg, Rr, Gg, Ww, Ww, Ww, Gs^Fp, Gs^Fp, Gg, Gg, Gg, Rr, Gg, Gg, Gg, Gg, Gg
Ww, Gg, Gs^Fp, Gs^Fp, Gs^Fp, Gg, Ww, Ww, Gg, Ww, Ww, Ww, Ww, Ch, Ww, Gg^Vh, Ww, Ww, Ww, Gs^Fp, Gg^Ve, Gs^Fp, Gg, Gg, Rr, Aa, Ww, Gg, Gg, Gg
Aa, Ww, Gs^Fp, Gs^Fp, Gg, Gg, Ww, Gs^Fp, Gs^Fp, Ww, Ww, Ww, Gg, Rr, Ww, Ww, Ww, Ww, Ww, Gs^Fp, Gg, Gs^Fp, Gs^Fp, Rr, Gg, Gg, Ww, Ww, Ww, Gs^Fp
Ww, Ww, Gg, Gs^Fp, Gs^Fp, Gs^Fp, Gs^Fp, Ww, Gg^Vh, Gg, Gg, Gs^Fp, Rr, Rr, Gg, Gg, Gg, Ww, Ww, Ww, Gg, Gg, Rr, Rr, Gg, Gg, Ww, Ww, Ww, Gs^Fp
Ww, Ww, Gg, Gs^Fp, Ww, Ww, Ww, Ww, Ww, Gg, Gs^Fp, Gs^Fp, Rr, Gs^Fp, Gg, Gg, Gg, Gg, Gg, Ww, Ww^Bw/, Rr, Gg, Gs^Fp, Ww, Gg, Ww, Ww, Gs^Fp, Gs^Fp
Gg, Gg^Vh, Ww, Ww, Gs^Fp, Ww, Gs^Fp, Ww, Rr, Gg, Rr, Rr, Gs^Fp, Gs^Fp, Gg, Gg, Aa, Aa, Gg, Rr, Gs^Fp, Ww, Ww, Gs^Fp, Ww, Ww, Gg^Vh, Ww, Ww, Gs^Fp
Ww, Ww, Ww, Ww, Ww, Gg, Rr, Rr, Gg, Rr, Gs^Fp, Gs^Fp, Gs^Fp, Gg^Ve, Gs^Fp, Gg, Gg, Aa, Aa, Rr, Gs^Fp, Gg^Ve, Gs^Fp, Ww, Ww, Ww, Gg, Ww, Ww, Gg
Gg, Ww, Ww, Ww, Rr, Rr, Gg, Gg, Gg, Gs^Fp, Hh, Hh, Hh, Hh, Hh, Hh, Rr, Rr, Gg, Gg, Gs^Fp, Gs^Fp, Gs^Fp, Gs^Fp, Gs^Fp, Gg, Gg, Gg, Gg, Ww
Ww, Gg, Gg, Gg, Rr, Gg, Gg, Hh, Hh^Vhh, Hh, Hh, Hh, Hh, Hh, Rr, Rr, Hh, Hh, Hh, Hh, Gg, Gs^Fp, Gs^Fp, Gs^Fp, Gg, Gg, Gg, Gg, Rr, Rr
Ww, Ww, Gg^Vh, Gs^Fp, Rr, Hh, Hh, Hh, Hh, Hh, Mm, Mm, Mm, Mm, Rr, Mm, Mm, Mm, Mm, Hh, Hh, Hh, Gs^Fp, Gg, Gg, Gg, Gg, Gg, Aa, Aa
Ww, Ww, Gs^Fp, Rr, Hh, Hh, Hh, Mm, Mm, Mm, Mm, Mm, Mm, Mm, Rr, Mm, Mm, Mm, Mm, Mm, Mm, Hh, Hh, Ch, Ch, Ch, Gg, Gg, Rr, Aa
Ww, Ww, Rr, Rr, Hh, Hh, Mm, Mm, Mm, Mm, Mm, Mm, Mm, Mm, Rr, Mm, Mm, Mm, Mm, Mm, Mm, Mm, Hh, Ch, 3 Kh, Ch, Rr, Aa, Aa, Gg
Ww, Ww, Rr, Ch, Ch, Ch, Mm, Mm, Mm, Mm, Mm, Mm, Mm, Mm^Vhh, Rr, Mm, Mm, Mm, Mm, Mm, Mm, Mm, Ch, Ch, Ch, Gg, Rr, Aa, Aa, Gg
Aa, Ww, Ww, Ch, 2 Kh, Ch, Mm, Mm, Mm, Mm, Mm, Mm, Mm, Rr, Mm, Mm, Mm, Mm, Mm, Mm, Mm, Mm, Mm, Mm, Rr, Rr, Aa, Aa, Aa, Gg
Aa, Aa, Ch, Ch, Ch, Hh, Mm, Mm, Mm, Mm, Mm, Mm, Rr, Rr, Mm, Mm, Mm, Mm, Mm, Mm, Mm, Mm, Rr, Rr, Hh, Ha, Aa, Aa, Aa, Gg
Aa, Aa, Ww, Gg, Hh, Hh, Mm, Mm, Mm, Mm, Mm, Mm, Rr, Mm, Mm, Mm, Mm, Mm, Mm, Mm, Rr, Rr, Mm, Mm^Vhh, Mm, Ha, Ha, Aa, Aa, Aa
Aa, Aa, Ww, Gg, Hh, Hh, Mm, Mm, Mm, Mm, Mm, Mm, Rr, Mm, Mm, Mm, Mm, Mm, Rr, Rr, Mm, Mm, Mm, Mm, Hh, Ha, Ha, Aa, Gg, Gg
Aa, Aa, Ww, Ww, Hh, Hh, Mm, Mm, Mm, Mm, Mm, Mm, Rr, Mm, Mm, Mm, Mm, Mm, Rr, Mm, Mm, Mm, Mm, Mm, Ha, Ha, Hh, Hh, Gg^Vh, Gs^Fp
Ai, Aa, Ww, Ww, Hh, Hh, Mm, Mm, Mm, Mm, Mm, Mm, Mm, Rr, Mm, Mm, Mm, Rr, Mm, Mm, Mm, Mm, Mm, Mm, Mm, Ha, Hh, Hh, Hh, Gs^Fp
