Hh, Hh, Hh, Hh, Hh, Hh, Hh, Hh, Gg, Hh, Hh, Gg, Gg, Gg, Gg, Rr, Gg, Gg, Gg, Gg, Rr, Gg
Hh, Hh, Hh, Hh, Hh, Gs^Fp, Hh, Hh, Rr, Rr, Rr, Gg, Gs^Fp, Gg, Gg, Rr, Gs^Fp, Gs^Fp, Gs^Fp, Gs^Fp, Gg^Ve, Rr
Hh, Hh, Gg, Gg, Hh, Gg^Vh, Rr, Rr, Hh, Hh, Hh, Rr, Rr, Gg, Gg, Rr, Rr, Gg, Gg, Gs^Fp, Gs^Fp, Rr
Hh, Gg, Gg, Ch, Ch, Ch, Gg, Hh, Gs^Fp, Hh, Gs^Fp, Gs^Fp, Gg, Rr, Dd, Gs, Gs, Gs, Gg, Gg, Gs^Fp, Gg
Hh, Hh, Hh, Ch, 1 Kh, Ch, Gg, Gs^Fp, Gs^Fp, Gs^Fp, Gs^Fp, Gs^Fp, Gg, Gg, Gg, Gs, Gs, Gs, Gg, Gg, Gg, Gs^Fp
Hh, Gs^Fp, Ch, Ch, Ch, Gg, Gg, Gs^Fp, Gs^Fp, Gg, Hh, Gg^Ve, Hh, Hh, Gs, Gs, Gs, Rr, Gg, Gs^Fp, Gs^Fp, Gs^Fp
Gg, Gg, Gs^Fp, Gg, Gg, Gg, Gg, Gg^Ve, Gg, Gg, Hh, Hh, Hh, Hh, Hh, Gg, Gs^Fp, Rr, Gg^Vh, Gs^Fp, Gs^Fp, Gs^Fp
Gg, Gs^Fp, Gg, Gg, Dd, Gg, Gg, Gs^Fp, Hh, Hh, Hh, Hh, Hhd, Hd, Hhd, Hh, Gs^Fp, Rr, Rr, Gg, Gg, Gs^Fp
Hh, Gs^Fp, Gs^Fp, Gg, Gg, Gg, Gg, Gs^Fp, Hh, Hh, Hh, Hh, Hhd, Hd, Hhd, Hh, Hh, Hh, Rr, Gg, Gg, Gg
Gg, Gg, Gs^Fp, Gs^Fp, Gg, Gg, Hh, Hh, Hh, Hh, Hh, Hh, Hh, Hhd, Hh, Hh, Hh, Hh, Gg, Rr, Rr, Gg
Gg, Hh, Hh, Gg, Hh, Hh, Hh, Hh, Rr^Vd, Hh, Hh, Hh, Mm, Hh, Hh, Mm, Hh, Hh, Hhd, Dd, Gg, Rr
Gs^Fp, Hh, Hh, Hh, Hh, Hhd, Hhd, Hhd, Hhd, Hh, Mm, Hh, Mm, Mm, Mm, Mm, Mm, Rr^Vd, Hh, Hhd, Hh, Hh
Gg, Gs^Fp, Hh, Hh, Hh, Hhd, Hd, Hd, Mm, Mm, Mm, Mm, Mm, Mm, Mm, Mm, Mm, Mm, Mm, Hh, Hh, Hh
Gs^Fp, Hh, Hh, Rr^Vd, Hhd, Hhd, Hd, Hd, Mm, Mm, Mm, Mm, Mm, Mm, Mm, Mm, Mm, Mm, Mm, Mm, Mm, Mm
Gg, Hh, Hh, Hh, Hhd, Hd, Hhd, Hhd, Mm, Mm, Mm, Mm, Mm, Mm, Mm, Mm, Mm, Mm, Mm, Mm, Mm, Mm
Hh, Hh, Hh, Hh, Hh, Hhd, Hh, Mm, Mm, Mm, Mm, Mm, Mm, Mm, Mm, Mm, Mm, Mm, Mm, Mm, Mm, Mm
Hh, Hh, Hh, Hh, Hh, Mm, Hh, Hh, Hh, Hh, Hh, Hh, Hh, Rr^Vd, Hh, Hh, Hh, Hh, Hh, Mm, Mm, Mm
Hh, Hh, Hh, Hh, Hh, Mm, Hh, Gs^Efm, Gs^Efm, Hh, Gs^Efm, Gs^Efm, Gs^Efm, Hh, Gs^Efm, Hh, Gs^Efm, Hh, Hh, Hh, Mm, Mm
Hh, Hh, Hh, Hh, Hh, Mm, Hh, Gs^Efm, Gs^Efm, Gs^Efm, Gs^Efm, Gs^Efm, Ce, Gs^Efm, Ce, Gs^Efm, Gs^Efm, Gs^Efm, Gs^Efm, Hh, Mm, Mm
Hh, Hh, Hh, Mm, Mm, Rr^Vd, Hh, Hh, Gs^Efm, Gs^Efm, Ce, Ce, Ce, Ce, 2 Ke, Ce, Gs^Efm, Gs^Efm, Gs^Efm, Hh, Mm, Mm
Hh, Hh, Mm, Mm, Mm, Mm, Mm, Hh, Hh, Gs^Efm, Gs^Efm, Gs^Efm, Gs^Efm, Gs^Efm, Gs^Efm, Gs^Efm, Gs^Efm, Gs^Efm, Hh, Hh, Mm, Rr
Hh, Hh, Mm, Mm, Rr^Vd, Mm, Mm, Hh, Hh, Gs^Efm, Gs^Efm, Gs^Efm, Gs^Efm, Gs^Efm, Hh, Gs^Efm, Hh, Hh, Mm, Rr^Vd, Mm, Mm
Hh, Mm, Mm, Mm, Mm, Mm, Mm, Hh, Hh, Gs^Efm, Hh, Hh, Hh, Hh, Hh, Hh, Mm, Mm, Mm, Mm, Mm, Mm
Hh, Mm, Mm, Mm, Mm, Mm, Mm, Mm, Mm, Hh, Mm, Hh, Mm, Mm, Mm, Mm, Mm, Mm, Mm, Mm, Rr, Rr
Hh, Hh, Mm, Mm, Mm, Mm, Mm, Mm, Mm, Mm, Mm, Mm, Mm, Mm, Mm, Mm, Rr^Vd, Mm, Rr, Rr, Mm, Mm
Hh, Hh, Mm, Mm, Mm, Mm, Mm, Mm, Mm, Mm, Mm, Mm, Mm, Mm, Mm, Mm, Rr, Rr, Mm, Mm, Mm, Hh
