Dd, Dd, Dd, Dd, Dd, Dd, Gs, Gs, Gs, Gs, Wwt, Wwt, Dd, Dd, Dd, Gs^Ft, Rd, Rd, Hd, Hd, Hd, Hd, Hd, Hd, Hd, Rd, Rd, Rd, Gs^Ft, Dd, Dd, Dd, Rd, Rd, Rd, Rd, Rd, Rd, Ww, Dd, Dd, Dd, Dd, Ww, Ww, Ww
Dd, Dd, Dd, Dd, Dd, Dd, Dd, Gs^Ft, Gs, Gs, Gs, Wwt, Wwt, Dd, Dd^Vda, Gs^Ft, Rd, Rd, Hd, Hd, Hd, Hd, Hd, Hd, Hd, Rd, Rd, Gs^Ft, Rd, Gs^Ft, Gs^Ft, Gs^Ft, Rd, Rd, Rd, Rd, Gg^Vh, Rd, Dd, Ww, Dd^Vda, Ww, Ww, Ww, Ww, Ww
Dd, Dd, Gs, Dd, Dd, Dd, Dd, Dd, Gs, Gs, Gs, Gs^Ft, Wwt, Dd, Dd, Gs^Ft, Rd, Rd, Rd, Hd, Hd, Hd, Hd, Rd, Rd, Rd, Rd, Rd, Rd, Rd, Rd, Rd, Gg^Vh, Dd, Dd, Dd, Ww, Ww, Ww, Ww, Ww, Ww, Ww, Ww, Ww, Ww
Dd, Dd, Dd, Ch, Ch, Ch, Rd, Dd, Dd, Gs^Ft, Gs^Ft, Gs^Ft, Dd, Wwt, Wwt, Rd, Rd, Rd, Rd, Hd, Hd, Hd, Gs^Ft, Hd, Rd, Rd, Rd, Rd, Rd, Rd, Dd, Ww, Dd, Ww, Ww, Ww, Ww, Ww, Ww, Ww, Ww, Ww, Ww, Ww, Ww, Ww
Dd, Dd, Dd, Ch, 1 Kh, Ch, Dd, Rd, Rd, Dd, Dd, Gs^Ft, Gs, Wwt, Wwt, Gs, Gs, Rd, Gs, Hd, Hd, Hd, Hd, Rd, Rd, Rd, Dd, Dd, Dd, Dd, Ww, Ww, Ww, Ww, Ww, Ww, Ww, Ww, Ww, Ww, Ww, Ww, Wo, Ww, Ww, Ww
Dd, Dd, Ch, Ch, Ch, Dd, Dd^Vda, Dd, Dd, Rd, Dd, Gs^Ft, Rd, Gs, Gs, Wwt, Wwt, Gs, Wwt, Hd, Wwt, Hd, Wwt, Rd, Rd, Gs^Ft, Dd, Dd, Dd, Dd, Ww, Ww, Ww, Ww, Wo, Wo, Wo, Ww, Ww, Ww, Ww, Ww, Ww, Ww, Ww, Ww
Dd, Hd, Hd, Dd, Dd, Dd, Dd, Dd, Dd, Rd, Dd, Rd, Rd, Rd, Gs, Gs, Gs, Wwt, Gs, Wwt, Hd, Wwt, Wwt, Gs, Gs, Dd, Dd, Dd, Dd, Ww, Ww, Ww, Ww, Ww, Wo, Wo, Ww, Ww, Ww, Ww, Ww, Ww, Ww, Ww, Dd, Dd
Hd, Hd, Hd, Dd, Hd, Dd, Dd, Dd, Dd, Rd, Re, Rd, Rd, Rd, Rd, Gs, Rd, Gs, Dd, Gs, Gs, Gs^Ft, Gs^Ft, Wwt, Wwt, Gs, Gs, Dd, Dd, Ww, Ww, Ww, Ww, Ww, Ww, Ww, Ww, Ww, Ww, Dd, Ww, Gg^Vh, Gs, Gs, Gs, Gs
Hd, Hd, Hd, Hd, Hd, Hd, Dd, Dd, Dd, Dd, Rd, Gg^Vh, Rd, Rd, Rd, Rd, Rd, Rd, Dd, Dd, Dd, Gs, Dd^Vda, Gs, Wwt, Wwt, Wwt, Dd, Ww, Ww, Ww, Ww, Ww, Ww, Ww, Ww, Dd, Dd, Dd, Dd, Ww, Dd, Gs, Gs, Gs, Gs
Hd, Hd, Hd, Hd, Hd, Hd, Hd, Hd, Dd, Dd, Gs^Ft, Re, Rd, Rd, Rd, Rd, Rd, Rd, Gs^Ft, Dd, Dd^Vda, Dd, Dd, Gs, Gs, Wwt, Gs^Ft, Ww, Gs^Ft, Ww, Ww, Ww, Ww, Ww, Ww, Dd^Vda, Dd, Dd, Dd, Ww, Dd, Dd, Dd, Dd, Gs^Ft, Gs^Ft
Hd, Hd, Hd, Dd^Vdt, Hd, Hd, Hd, Hd, Hd, Dd, Gs^Ft, Re, Rd, Rd, Rd, Rd, Rd, Rd, Rd, Dd, Dd, Dd, Dd, Dd, Dd, Gs^Ft, Ww, Ww, Dd, Gg^Vh, Ww, Ww, Ww, Ww, Ww, Gs, Dd, Dd, Ww, Ww, Ww, Hd, Ww, Hd, Dd, Dd
Hd, Hd, Hd, Hd, Hd, Hd, Hd, Hd, Hd, Hd, Hd, Re, Rd, Rd, Rd, Rd, Gs^Ft, Rd, Rd, Dd, Dd, Dd, Dd, Dd, Ww, Ww, Gs, Dd, Dd, Gs^Ft, Gs, Ww, Ww, Dd, Ww, Gs^Ft, Dd, Dd, Ww, Ww, Ww, Ww, Ww, Hd, Hd, Hd
Hd, Hd, Hd, Hd, Hd, Hd, Hd, Hd, Hd, Hd, Hd, Re, Re, Dd, Dd, Dd, Dd, Dd, Rd, Rd, Dd, Dd, Dd, Ww, Gs, Gs, Gs, Gs^Ft, Dd, Dd, Gs^Ft, Gs, Ww, Ww, Gs, Ww, Dd, Hd, Ww, Ww, Ww, Ww, Ww, Mdd, Mdd, Hd
Hd, Hd, Hd, Hd, Hd, Hd, Hd, Hd, Hd, Hd, Hd, Hd, Re, Dd, Dd, Dd, Dd, Dd, Rd, Rd, Gs^Ft, Dd, Ww, Ww, Gs, Gs, Gs, Gs^Ft, Dd, Dd, Dd, Gs^Ft, Gs, Gs, Gs, Ww, Ww, Ww, Ww, Ww^Vm, Ww, Ww, Ww, Mdd, Mdd, Hd
Hd, Hd, Gg^Vh, Gs, Hd, Hd, Hd, Hd, Hd, Hd, Hd, Hd, Re, Dd, Dd, Dd, Dd, Gs^Ft, Rd, Rd, Gs^Ft, Gs^Ft, Ww, Gs, Gs, Gs, Gg^Vh, Hd, Dd, Hd, Dd, Dd, Gs^Ft, Gs, Gs, Ww, Ww, Ww, Ww, Ww, Ww, Ww, Mdd, Mdd, Mdd, Mdd
Rd, Hd, Rd, Gs^Ft, Gs^Ft, Hd, Hd, Hd, Hd, Hd, Hd, Rd, Re, Dd, Dd, Dd^Vda, Dd, Gs^Ft, Rd, Rd, Rd, Rd, Ww, Gs, Gs, Gs, Hd, Hd, Hd, Hd, Hd, Dd, Dd, Gs, Ww, Ww, Ww, Ww, Ww, Ww, Mdd, Mdd, Mdd, Mdd, Mdd, Mdd
Rd, Rd, Rd, Rd, Rd, Gs^Ft, Dd, Hd, Hd, Hd, Rd, Rd, Re, Gs^Ft, Gs^Ft, Dd, Dd, Dd, Rd, Rd, Rd, Rd, Gg^Vh, Ww, Gs, Gs, Hd, Hd, Mdd, Mdd, Hd, Dd, Gs^Ft, Gs, Ww, Ww, Ww, Ww, Ww, Ww, Mdd, Mdd, Mdd, Mdd, Mdd, Hd
Rd, Rd, Rd, Rd, Rd, Gs^Ft, Gs^Vht, Gs^Ft, Gs^Ft, Rd, Rd, Rd, Re, Rd, Rd, Gs^Ft, Dd, Gs^Ft, Rd, Rd, Rd, Rd, Rd, Ww, Gs^Ft, Hd, Hd, Mdd, Mdd, Mdd, Hd, Hd, Hd, Gs, Hd, Dd^Vdt, Ww, Ww, Mdd, Mdd, Mdd, Mdd, Mdd, Mdd, Hd, Rd
Rd, Rd, Rd, Gs^Ft, Rd, Rd, Gs^Ft, Dd, Dd, Gs^Ft, Rd, Rd, Re, Gg^Vh, Rd, Rd, Rd, Rd, Rd, Rd, Rd, Rd, Gs^Ft, Ww, Dd, Hd, Mdd, Mdd, Mdd, Mdd, Mdd, Hd, Hd, Hd, Hd, Hd, Hd, Hd, Hd, Hd, Hd, Hd, Hd, Hd, Hd, Rd
Rd, Gs^Ft, Dd, Gs^Ft, Rd, Rd, Gs^Ft, Dd, Gs^Ft, Gs^Ft, Gs^Ft, Rd, Rd, Re, Re, Rd, Rd, Gs^Ft, Rd, Rd, Rd, Rd, Gs^Vht, Ww, Hd, Mdd, Mdd, Ww, Mdd, Mdd, Mdd, Hd, Hd, Hd, Hd, Hd, Hd, Hd, Hd, Hd, Hd, Hd, Hd, Dd, Rd, Rd
Rd, Dd, Gs^Ft, Rd, Rd, Rd, Rd, Rd, Dd, Dd, Dd, Rd, Gg^Vh, Rd, Rd, Re, Rd, Rd, Rd, Rd, Rd, Rd, Gs^Ft, Ww, Ww, Ww, Ww, Ww, Mdd, Mdd, Hd, Hd, Hd, Hd, Hd, Hd, Hd, Hd, Hd, Hd, Hd, Dd, Dd, Rd, Dd, Dd
Gs^Ft, Rd, Rd, Rd, Rd, Rd, Rd, Rd, Dd, Hd, Hd, Hd, Rd, Rd, Rd, Re, Rd, Rd, Rd, Rd, Rd, Rd, Dd, Hd, Ww, Ww, Ww, Ww, Ww, Ww, Ww, Hd, Hd, Gg^Vh, Hd, Hd, Hd, Hd, Hd, Hd, Dd, Dd, Dd, Rd, Dd, Dd
Rd, Rd, Rd, Rd, Rd, Rd, Rd, Rd, Hd, Hd, Hd, Hd, Gs^Ft, Rd, Rd, Re, Re, Rd, Hd, Rd, Gs^Ft, Gs^Ft, Hd, Hd, Mdd, Ww, Ww, Ww, Ww, Ww, Ww, Hd, Dd, Gs^Ft, Hd, Hd, Hd, Hd, Hd, Dd, Dd^Vda, Dd, Dd, Rd, Dd, Dd
Gs^Ft, Dd, Gs^Ft, Rd, Rd, Rd, Rd, Hd, Hd, Hd, Hd, Hd, Hd, Hd, Rd, Gg^Vh, Re, Rd, Rd, Hd, Hd, Hd, Hd, Hd, Mdd, Mdd, Mdd, Ww, Ww, Dd^Vdt, Hd, Dd, Dd, Gs^Ft, Hd, Hd, Hd, Hd, Hd, Dd, Dd, Dd, Rd, Re, Gs, Gs
Dd, Dd, Dd, Dd, Gs^Ft, Rd, Hd, Hd, Hd, Hd, Hd, Hd, Hd, Hd, Rd, Rd, Re, Rd, Dd, Hd, Hd, Hd, Hd, Mdd, Mdd, Mdd, Mdd, Hd, Hd, Hd, Gs^Ft, Dd, Dd, Dd, Gs^Ft, Dd, Dd, Dd, Dd, Dd, Rd, Rd, Gs^Ft, Gs, Gs, Gs
Dd, Dd, Dd, Dd, Dd, Rd, Rd, Hd, Hd, Hd, Hd, Ch, Ch, Ch, Gs^Ft, Dd, Rd, Dd, Dd, Hd, Hd, Hd, Hd, Hd, Mdd, Mdd, Hd, Hd, Hd, Dd, Gs^Ft, Gs^Ft, Dd, Gs^Ft, Gs^Ft, Gs, Dd, Dd, Rd, Ch, Ch, Ch, Gs^Ft, Gs, Gs, Gs
Dd, Dd, Dd, Dd, Dd^Vda, Dd, Rd, Hd, Hd, Hd, Hd, Ch, 3 Kh, Ch, Gs^Ft, Dd, Rd, Dd, Gs^Ft, Hd, Hd, Hd, Hd, Hd, Hd, Hd, Hd, Hd, Dd, Gs^Ft, Gs, Gs^Ft, Gs^Ft, Gs, Gs, Gs, Re, Rd, Rd, Ch, 2 Kh, Ch, Dd, Gs, Gs, Gs
Dd, Dd, Rd, Dd, Dd, Dd, Dd, Gs^Ft, Dd, Hd, Ch, Ch, Ch, Rd, Gs^Ft, Dd, Rd, Dd, Gs^Ft, Dd, Hd, Hd, Hd, Hd, Hd, Hd, Dd, Dd, Gs^Ft, Dd, Gs^Ft, Dd, Gs, Gs, Gs, Gs, Re, Rd, Ch, Ch, Ch, Hd, Ww, Hd, Hd, Gs
Rd, Rd, Dd, Rd, Rd, Dd, Dd, Dd, Dd, Dd, Dd, Rd, Rd, Rd, Rd, Gs^Ft, Gs^Ft, Rd, Rd, Dd, Dd, Hd, Hd, Hd, Hd, Dd, Dd, Gs^Ft, Gs, Gs^Ft, Dd, Dd, Dd, Gs, Gs, Gg^Vh, Re, Rd, Dd, Dd, Hd, Hd, Ww, Hd, Hd, Hd
Dd, Dd, Dd, Dd, Dd, Rd, Rd, Gs^Ft, Dd, Dd, Dd, Rd, Rd, Rd, Rd, Rd, Rd, Gs^Ft, Gs^Vht, Re, Hd, Hd, Hd, Hd, Hd, Dd, Dd^Vda, Dd, Gs^Ft, Gs^Ft, Dd, Dd, Dd, Gs^Ft, Gs, Re, Gs, Dd, Dd, Hd, Ww, Dd^Vdt, Ww, Ww, Hd, Ww
Dd, Dd, Dd, Dd, Dd, Gs^Ft, Re, Gs, Gs^Ft, Gs^Ft, Rd, Rd, Rd, Rd, Rd, Rd, Rd, Rd, Gs^Ft, Re, Rd, Hd, Hd, Hd, Dd, Dd, Dd, Dd, Gs^Ft, Gs, Dd, Dd, Dd, Dd, Re, Re, Gs, Dd, Ww, Ww, Hd, Ww, Ww, Ww, Ww, Ww
Dd, Dd, Dd, Dd, Gs^Ft, Gs^Ft, Gs, Re, Re, Re, Gs, Re, Re, Rd, Rd, Rd, Rd, Dd, Dd, Dd, Dd, Rd, Rd, Rd, Rd, Rd, Rd, Rd, Re, Gs, Re, Gs^Ft, Dd, Dd, Re, Gs, Ww, Ww, Hd, Ww, Hd, Mdd, Ww, Ww, Ww, Ww
